111111111111111111111111111111111111111111111111111111111111111
1000000001111101111111C0000111100000011111001101101010000000001
100000000000000000000000000000000000000000000000000000000000001
11110000C00000011111111100000000P0000000111111C0000000000111111
100000001111100000000000000111111111110000000000011111000000001
1000000000000000001111110000000C0000000000001111111111111110001
111111100000000111100000000011111111110000000000000000000000011
1111C00000011000C1100000011110000001111111110011111101111110011
111111100000001111000000000000011100000000000111000000000011111
11100000000000001111111111111100E000111111111111110000000C11111
111111111111111111111111111111111111111111111111111111111111111